166:39|
XXXXXXXXXXXXXXXXXXXXXXXXXXXXXXXXXXXXX
XF                                  X
XF                                  X
XF                                  X
XBBBB                               X
X       J                           X
X    *         J                    X
X       *  B                        X
X             *  * BBBB             X
X                         J    J    X
X                        * *        X
X                                   X
X                                BBBX
X                                   X
X                         BBBB      X
X         B    J                    X
X      B  B         B  J            X
X   B  B  B         B               X
X   BSSBSSBSSSSSSSSSBSSSSSSSSSSSSSSSX
XXXXXXXXXXXXXXXXXXXXXXXXXXXXXXXXXXXXX
-166:39|
XXXXXXXXXXXXXXXXXXXXXXXXXXXXXXXXXXXXX
XFFB   *                            X
X  B  *                             X
X  B *                              X
X  B*           BBB    J            X
X  B            B          BBB      X
X               B * * *             X
X         B * * B                BBBX
X   G     B                   J     X
X         B          G              X
X         BSSSSSS                   X
X * * * * BBBBBBB     BBBBB      *  X
X               B     B             X
X               B     B     *       X
X                     B          *  X
X      B  G           B             X
X      B                    *       X
X   B  B                            X
X   BSSBSSSSSSSSSSSSSSSSSSSSSSSSSSSSX
XXXXXXXXXXXXXXXXXXXXXXXXXXXXXXXXXXXXX
-166:39|
XXXXXXXXXXXXXXXXXXXXXXXXXXXXXXXXXXXXXXXX
X   *                  BBBBBBBBBBBBBBBBX
X  *                   O               X
X *                    O               X
X*          J   J      O     SSSSS     X
X      BBB   * *    BBBBBBBBBBBBBB     X
X                *               B    *X
X   J          G         *       B   * X
X                 *SSSS*   *SSSSSB     X
X      BBB         BBBB  J  BBBBBB     X
X                     C          B*    X
X* * * * * BBBBB      C          B *   X
X              B      C          B     X
X              B      C          B     X
X              BBBBBBBB***       B    *X
X              B                 B   * X
X          BOOOB                 B     X
X      B   B                SSSSSB     X
X  BSSSBSSSB      SSSSBBBBBBBBBBBBFFFFFX
XXXXXXXXXXXXXXXXXXXXXXXXXXXXXXXXXXXXXXXX
-166:39|
XXXXXXXXXXXXXXXXXXXXXXXXXXXXXXXXXXXXXX
X *      *  *    O     *   B   *   B X
X*        **     O                   X
X                O                   X
X     S        S O                   X
X     BBBBBBBBBBBB *   B   *   B   * X
XFFFFFB *      * B                   X
XBBBBBB*        *B                   X
X*    O          B                   X
X     O    **    B B   *   B   *   B X
X     O   *SS*   B                   X
X   BBBBBBBBBBPPPB               BPPPX
X  *B *  *  *    B               B   X
X   B*  *  *     B *   B   *   B B   X
X   B            B               B   X
X   B            B* * * * * * * *BOOOX
X*  B            B     C             X
X   B            B     C             X
X   B   SSSSSSSSSB     C             X
XPPPB   BBBBBBBBBB   BBB         BBBBX
X   B                     J   J   * *X
X   B                *           * * X
X   B                             * *X
X  BBSSSSSSSSSSSSSSSS*           * * X
X BBBBBBBBBBBBBBBBBBBBSSSSSSSSSSSSSSSX
XXXXXXXXXXXXXXXXXXXXXXXXXXXXXXXXXXXXXX
